11111111111111111
1000C0000000001C1
10000000000000011
1110000E000000001
1P10000000000C001
11111111111111111