11111111111111111
1000C000000000001
10000001000000001
1110001E100000001
1P000001000000001
11111111111111111