11111111111111111
1000C000000000001
10000000000000001
1110000E000000001
1P100000000000001
11111111111111111