11111111111111
10000000C00001
10P00000000001
100000E0000001
11111111111111