111111111
1000001C1
100001PE1
111111111