1111111111111111111111111111111111
1E0X00000000000C00000C000000000001
1010010100100X00101001000X00010101
1010010010101010001001000000010101
1P0000000C00C000000000000X000000C1
1111111111111111111111111111111111